player,position,age,team,games,game_starts,minutes,fgm,fga,fg_percent,fg3m,fg3a,fg3_percent,fg2m,fg2a,fg2_percent,e_fg_percent,ftm,fta,ft_percent,oreb,dreb,treb,ast,stl,blk,tov,pf,pts,player_additional
Kevin Durant,PF,34,BRK,25,25,922,265,479,0.553,39,115,0.339,226,364,0.621,0.594,178,194,0.918,9,157,166,135,18,44,86,62,747,duranke01
Jayson Tatum,PF,24,BOS,24,24,887,242,504,0.48,82,225,0.364,160,279,0.573,0.562,172,198,0.869,27,172,199,101,24,25,66,54,738,tatumja01
Luka Dončić,PG,23,DAL,22,22,810,254,498,0.51,61,178,0.343,193,320,0.603,0.571,165,230,0.717,19,168,187,188,40,15,79,64,734,doncilu01
Stephen Curry,PG,34,GSW,23,23,800,233,467,0.499,117,271,0.432,116,196,0.592,0.624,106,117,0.906,12,140,152,162,24,6,72,49,689,curryst01
Shai Gilgeous-Alexander,SG,24,OKC,22,22,786,235,464,0.506,22,67,0.328,213,397,0.537,0.53,197,212,0.929,21,84,105,132,39,25,73,54,689,gilgesh01
Devin Booker,SG,26,PHO,24,24,859,244,500,0.488,57,146,0.39,187,354,0.528,0.545,136,156,0.872,20,97,117,142,24,10,61,64,681,bookede01
Donovan Mitchell,SG,26,CLE,22,22,803,216,443,0.488,85,202,0.421,131,241,0.544,0.584,108,122,0.885,18,67,85,107,30,10,68,54,625,mitchdo01
Jaylen Brown,SF,26,BOS,23,23,826,228,452,0.504,55,157,0.35,173,295,0.586,0.565,104,125,0.832,22,141,163,84,22,10,71,63,615,brownja02
Trae Young,PG,24,ATL,22,22,781,194,476,0.408,48,162,0.296,146,314,0.465,0.458,171,190,0.9,17,47,64,212,16,3,76,30,607,youngtr01
Giannis Antetokounmpo,PF,28,MIL,19,19,626,223,410,0.544,15,63,0.238,208,347,0.599,0.562,145,234,0.62,39,176,215,104,16,20,70,65,606,antetgi01
DeMar DeRozan,SF,33,CHI,23,23,801,208,414,0.502,10,32,0.313,198,382,0.518,0.514,160,181,0.884,11,90,101,107,21,9,45,63,586,derozde01
Lauri Markkanen,SF,25,UTA,26,26,881,207,392,0.528,69,167,0.413,138,225,0.613,0.616,95,114,0.833,57,165,222,58,15,18,56,53,578,markkla01
Anthony Davis,C,29,LAL,20,20,692,217,368,0.59,9,27,0.333,208,341,0.61,0.602,129,155,0.832,68,188,256,52,27,48,40,57,572,davisan02
Ja Morant,PG,23,MEM,20,20,665,198,427,0.464,37,100,0.37,161,327,0.492,0.507,136,183,0.743,26,100,126,149,21,5,76,38,569,moranja01
Anfernee Simons,SG,23,POR,22,22,817,187,422,0.443,93,234,0.397,94,188,0.5,0.553,76,85,0.894,7,60,67,100,22,6,48,49,543,simonan01
Anthony Edwards,SG,21,MIN,23,23,840,192,416,0.462,59,171,0.345,133,245,0.543,0.532,86,113,0.761,13,116,129,88,38,9,73,64,529,edwaran01
Jerami Grant,PF,28,POR,23,23,835,172,362,0.475,65,141,0.461,107,221,0.484,0.565,119,153,0.778,20,75,95,64,19,20,44,52,528,grantje01
Jalen Green,SG,20,HOU,24,24,832,176,424,0.415,57,179,0.318,119,245,0.486,0.482,109,137,0.796,15,80,95,95,20,5,80,42,518,greenja05
Dejounte Murray,SG,26,ATL,24,24,886,205,454,0.452,53,145,0.366,152,309,0.492,0.51,54,65,0.831,19,117,136,156,44,11,64,42,517,murrade01
Jordan Clarkson,SG,30,UTA,26,26,841,185,428,0.432,70,200,0.35,115,228,0.504,0.514,72,87,0.828,32,70,102,124,9,9,69,54,512,clarkjo01
Joel Embiid,C,28,PHI,16,16,565,166,323,0.514,15,54,0.278,151,269,0.561,0.537,163,194,0.84,26,127,153,79,18,28,66,53,510,embiijo01
Julius Randle,PF,28,NYK,24,24,796,175,380,0.461,51,157,0.325,124,223,0.556,0.528,106,136,0.779,51,152,203,83,17,4,66,77,507,randlju01
Jalen Brunson,PG,26,NYK,24,24,775,181,375,0.483,34,100,0.34,147,275,0.535,0.528,109,125,0.872,11,71,82,150,24,5,42,59,505,brunsja01
Kristaps Porziņģis,PF,27,WAS,23,23,747,169,361,0.468,48,135,0.356,121,226,0.535,0.535,116,146,0.795,51,152,203,58,19,35,42,74,502,porzikr01
Bojan Bogdanović,PF,33,DET,24,24,759,165,325,0.508,57,136,0.419,108,189,0.571,0.595,107,122,0.877,12,76,88,59,12,0,55,43,494,bogdabo02
De'Aaron Fox,PG,25,SAC,21,21,665,180,349,0.516,40,106,0.377,140,243,0.576,0.573,86,105,0.819,10,97,107,122,23,10,55,52,486,foxde01
Kelly Oubre Jr.,SF,27,CHO,24,24,776,180,418,0.431,55,175,0.314,125,243,0.514,0.496,68,93,0.731,38,88,126,30,40,6,27,73,483,oubreke01
Franz Wagner,SF,21,ORL,25,25,829,179,361,0.496,33,101,0.327,146,260,0.562,0.542,91,105,0.867,20,82,102,94,19,6,69,63,482,wagnefr01
Kyle Kuzma,PF,27,WAS,23,23,793,180,392,0.459,51,167,0.305,129,225,0.573,0.524,62,84,0.738,23,153,176,82,9,11,58,63,473,kuzmaky01
Nikola Jokić,C,27,DEN,20,20,643,174,274,0.635,16,47,0.34,158,227,0.696,0.664,100,124,0.806,39,163,202,178,26,12,65,59,464,jokicni01
OG Anunoby,SF,25,TOR,24,24,876,174,361,0.482,38,111,0.342,136,250,0.544,0.535,72,87,0.828,35,103,138,52,56,21,63,72,458,anunoog01
Bam Adebayo,C,25,MIA,22,22,772,176,335,0.525,1,9,0.111,175,326,0.537,0.527,103,118,0.873,51,146,197,73,22,17,67,73,456,adebaba01
Keldon Johnson,SF,23,SAS,22,22,711,157,400,0.393,64,185,0.346,93,215,0.433,0.473,70,96,0.729,21,91,112,68,20,2,50,43,448,johnske04
RJ Barrett,SG,22,NYK,24,24,802,153,377,0.406,37,131,0.282,116,246,0.472,0.455,98,126,0.778,22,107,129,71,12,2,55,54,441,barrerj01
Bennedict Mathurin,SG,20,IND,24,1,685,137,329,0.416,48,128,0.375,89,201,0.443,0.489,117,146,0.801,29,63,92,37,15,2,44,47,439,mathube01
Kevin Porter Jr.,PG,22,HOU,23,23,799,147,355,0.414,48,137,0.35,99,218,0.454,0.482,96,126,0.762,34,98,132,134,29,10,89,68,438,porteke02
Karl-Anthony Towns,PF,27,MIN,21,21,709,153,303,0.505,38,117,0.325,115,186,0.618,0.568,92,104,0.885,35,137,172,111,16,14,65,82,436,townska01
Zion Williamson,PF,22,NOP,18,18,576,163,276,0.591,3,11,0.273,160,265,0.604,0.596,96,132,0.727,38,89,127,77,23,11,49,41,425,willizi01
Jordan Poole,SG,23,GSW,25,6,688,149,342,0.436,60,180,0.333,89,162,0.549,0.523,66,79,0.835,7,44,51,112,21,8,73,57,424,poolejo01
Tyrese Haliburton,PG,22,IND,22,22,731,155,336,0.461,58,157,0.369,97,179,0.542,0.548,52,62,0.839,17,86,103,239,40,6,58,24,420,halibty01
Andrew Wiggins,SF,27,GSW,22,22,722,163,319,0.511,67,149,0.45,96,170,0.565,0.616,27,43,0.628,34,79,113,48,30,17,30,64,420,wiggian01
LeBron James,PF,38,LAL,16,16,566,163,350,0.466,39,118,0.331,124,232,0.534,0.521,53,74,0.716,23,114,137,105,19,10,55,32,418,jamesle01
Zach LaVine,SG,27,CHI,19,19,652,147,348,0.422,54,154,0.351,93,194,0.479,0.5,70,85,0.824,15,72,87,80,24,1,41,47,418,lavinza01
Kyrie Irving,PG,30,BRK,17,17,627,155,328,0.473,44,136,0.324,111,192,0.578,0.54,61,68,0.897,11,63,74,74,16,16,39,50,415,irvinky01
Bradley Beal,SG,29,WAS,18,18,631,156,299,0.522,31,88,0.352,125,211,0.592,0.574,69,79,0.873,15,52,67,97,21,11,51,34,412,bealbr01
Buddy Hield,SG,30,IND,24,24,759,142,343,0.414,83,227,0.366,59,116,0.509,0.535,38,45,0.844,25,92,117,64,24,9,51,51,405,hieldbu01
Darius Garland,PG,23,CLE,18,18,646,135,311,0.434,51,125,0.408,84,186,0.452,0.516,79,92,0.859,5,34,39,139,22,4,59,36,400,garlada01
Paul George,SF,32,LAC,17,17,577,140,303,0.462,47,125,0.376,93,178,0.522,0.54,70,82,0.854,9,90,99,76,25,7,60,44,397,georgpa01
Paolo Banchero,PF,20,ORL,18,18,619,132,294,0.449,16,65,0.246,116,229,0.507,0.476,111,152,0.73,23,99,122,68,14,11,53,39,391,banchpa01
Devin Vassell,SG,22,SAS,19,17,618,142,311,0.457,59,141,0.418,83,170,0.488,0.551,47,58,0.81,4,76,80,68,14,8,30,29,390,vassede01
Mikal Bridges,SF,26,PHO,24,24,876,147,285,0.516,42,94,0.447,105,191,0.55,0.589,48,54,0.889,27,98,125,80,26,23,27,53,384,bridgmi01
P.J. Washington,PF,24,CHO,24,24,774,141,330,0.427,48,139,0.345,93,191,0.487,0.5,51,63,0.81,26,87,113,54,18,24,45,61,381,washipj01
Spencer Dinwiddie,PG,29,DAL,23,23,726,136,296,0.459,62,152,0.408,74,144,0.514,0.564,45,55,0.818,8,64,72,113,23,6,36,51,379,dinwisp01
Deandre Ayton,C,24,PHO,22,22,639,163,262,0.622,4,13,0.308,159,249,0.639,0.63,46,63,0.73,63,148,211,47,11,19,42,64,376,aytonde01
Tobias Harris,PF,30,PHI,22,22,751,143,299,0.478,49,118,0.415,94,181,0.519,0.56,37,44,0.841,19,120,139,59,29,10,29,47,372,harrito02
Collin Sexton,SG,24,UTA,26,9,634,128,259,0.494,24,66,0.364,104,193,0.539,0.541,90,108,0.833,22,42,64,77,16,2,47,59,370,sextoco01
Domantas Sabonis,PF,26,SAC,22,22,705,133,222,0.599,10,27,0.37,123,195,0.631,0.622,92,122,0.754,48,193,241,144,16,11,55,84,368,sabondo01
Dillon Brooks,SG,27,MEM,21,21,658,138,350,0.394,46,138,0.333,92,212,0.434,0.46,45,60,0.75,17,63,80,61,20,2,36,67,367,brookdi01
Nikola Vučević,C,32,CHI,23,23,736,140,293,0.478,36,104,0.346,104,189,0.55,0.539,47,55,0.855,51,201,252,65,11,17,47,47,363,vucevni01
Evan Mobley,PF,21,CLE,24,24,820,149,264,0.564,5,22,0.227,144,242,0.595,0.574,57,84,0.679,68,153,221,58,21,36,51,65,360,mobleev01
Klay Thompson,SG,32,GSW,20,20,607,127,316,0.402,78,200,0.39,49,116,0.422,0.525,28,33,0.848,10,61,71,49,12,7,32,35,360,thompkl01
Kyle Lowry,PG,36,MIA,24,24,874,106,264,0.402,57,162,0.352,49,102,0.48,0.509,82,96,0.854,20,98,118,145,25,15,62,70,351,lowryky01
Gary Trent Jr.,SG,24,TOR,21,16,646,121,286,0.423,47,140,0.336,74,146,0.507,0.505,61,79,0.772,13,29,42,32,34,3,23,29,350,trentga02
Malik Beasley,SG,26,UTA,26,2,690,123,301,0.409,81,210,0.386,42,91,0.462,0.543,18,20,0.9,17,83,100,40,25,4,24,34,345,beaslma01
D'Angelo Russell,PG,26,MIN,23,23,724,127,291,0.436,44,138,0.319,83,153,0.542,0.512,46,59,0.78,15,62,77,154,30,13,63,47,344,russeda01
Tyrese Maxey,SG,22,PHI,15,15,546,126,273,0.462,43,102,0.422,83,171,0.485,0.54,48,65,0.738,6,46,52,66,15,4,30,35,343,maxeyty01
Pascal Siakam,C,28,TOR,14,14,486,121,247,0.49,19,53,0.358,102,194,0.526,0.528,82,109,0.752,24,100,124,99,14,7,34,45,343,siakapa01
Kevin Huerter,SG,24,SAC,22,22,700,120,253,0.474,66,156,0.423,54,97,0.557,0.605,36,52,0.692,9,62,71,71,23,9,33,52,342,huertke01
Jamal Murray,PG,25,DEN,19,19,567,130,294,0.442,38,100,0.38,92,194,0.474,0.507,43,55,0.782,10,61,71,94,18,5,38,24,341,murraja01
Luguentz Dort,SG,23,OKC,24,24,734,119,294,0.405,41,128,0.32,78,166,0.47,0.474,61,79,0.772,38,73,111,56,28,9,35,79,340,dortlu01
Terry Rozier,PG,28,CHO,16,16,597,129,335,0.385,40,133,0.301,89,202,0.441,0.445,42,50,0.84,21,55,76,93,12,3,42,31,340,roziete01
Kelly Olynyk,PF,31,UTA,26,26,741,117,209,0.56,41,88,0.466,76,121,0.628,0.658,64,80,0.8,34,96,130,83,33,19,58,107,339,olynyke01
Christian Wood,PF,27,DAL,20,0,521,125,226,0.553,28,68,0.412,97,158,0.614,0.615,59,87,0.678,25,130,155,27,8,11,50,57,337,woodch01
Brook Lopez,C,34,MIL,22,22,685,123,247,0.498,53,127,0.417,70,120,0.583,0.605,37,45,0.822,35,94,129,25,13,66,29,49,336,lopezbr01
Jaden Ivey,SG,20,DET,21,20,667,117,283,0.413,31,100,0.31,86,183,0.47,0.468,69,94,0.734,24,78,102,90,25,6,57,60,334,iveyja01
CJ McCollum,SG,31,NOP,19,19,663,130,327,0.398,42,127,0.331,88,200,0.44,0.462,28,35,0.8,18,75,93,114,21,10,38,33,330,mccolcj01
Jrue Holiday,PG,32,MIL,18,17,584,125,280,0.446,38,113,0.336,87,167,0.521,0.514,41,46,0.891,22,71,93,135,29,9,59,37,329,holidjr01
Norman Powell,SG,29,LAC,22,5,556,113,246,0.459,36,95,0.379,77,151,0.51,0.533,64,82,0.78,9,55,64,33,18,7,39,40,326,powelno01
Malik Monk,SG,24,SAC,22,0,490,118,242,0.488,46,125,0.368,72,117,0.615,0.583,42,47,0.894,8,38,46,94,16,4,41,40,324,monkma01
Max Strus,SF,26,MIA,22,13,727,114,270,0.422,65,183,0.355,49,87,0.563,0.543,30,35,0.857,12,65,77,37,20,7,26,51,323,strusma01
Aaron Gordon,PF,27,DEN,20,20,584,124,204,0.608,21,56,0.375,103,148,0.696,0.659,53,84,0.631,47,86,133,46,13,17,28,36,322,gordoaa01
Bobby Portis,PF,27,MIL,23,7,618,134,275,0.487,28,87,0.322,106,188,0.564,0.538,23,30,0.767,56,183,239,54,8,8,27,44,319,portibo01
Lonnie Walker IV,SG,24,LAL,19,19,594,117,242,0.483,39,100,0.39,78,142,0.549,0.564,44,51,0.863,7,37,44,33,17,8,20,33,317,walkelo01
Myles Turner,C,26,IND,19,18,519,111,204,0.544,28,71,0.394,83,133,0.624,0.613,66,81,0.815,27,119,146,27,10,43,33,60,316,turnemy01
Jimmy Butler,SF,33,MIA,15,15,533,103,208,0.495,12,34,0.353,91,174,0.523,0.524,97,112,0.866,33,74,107,90,25,4,30,24,315,butleji01
De'Andre Hunter,SF,25,ATL,21,21,648,113,253,0.447,28,79,0.354,85,174,0.489,0.502,59,73,0.808,14,70,84,23,7,3,28,63,313,huntede01
Marcus Morris,PF,33,LAC,23,23,690,122,274,0.445,46,126,0.365,76,148,0.514,0.529,23,31,0.742,11,101,112,45,18,8,21,53,313,morrima03
Bol Bol,PF,23,ORL,25,20,666,128,213,0.601,19,46,0.413,109,167,0.653,0.646,37,48,0.771,33,154,187,25,12,46,53,37,312,bolbo01
Brandon Ingram,SF,25,NOP,15,15,481,109,231,0.472,28,60,0.467,81,171,0.474,0.532,66,76,0.868,7,69,76,70,13,10,42,33,312,ingrabr01
Alperen Şengün,C,20,HOU,21,18,562,120,216,0.556,4,21,0.19,116,195,0.595,0.565,68,86,0.791,71,109,180,46,16,20,49,74,312,sengual01
Josh Giddey,SG,20,OKC,21,21,640,133,293,0.454,19,66,0.288,114,227,0.502,0.486,26,36,0.722,34,125,159,115,13,11,68,48,311,giddejo01
Damian Lillard,PG,32,POR,12,12,419,91,215,0.423,42,121,0.347,49,94,0.521,0.521,86,98,0.878,10,41,51,83,7,4,46,22,310,lillada01
Jonas Valančiūnas,C,30,NOP,23,23,530,117,211,0.555,15,36,0.417,102,175,0.583,0.59,59,71,0.831,60,147,207,46,7,8,44,57,308,valanjo01
Reggie Jackson,PG,32,LAC,25,25,732,115,273,0.421,39,112,0.348,76,161,0.472,0.493,38,43,0.884,10,55,65,108,16,3,58,47,307,jacksre01
Saddiq Bey,SF,23,DET,21,17,632,97,240,0.404,30,112,0.268,67,128,0.523,0.467,82,93,0.882,24,74,98,36,16,4,27,37,306,beysa01
Tyler Herro,SG,23,MIA,16,16,538,112,256,0.438,42,119,0.353,70,137,0.511,0.52,40,45,0.889,11,98,109,66,12,8,42,27,306,herroty01
Russell Westbrook,PG,34,LAL,21,3,588,112,277,0.404,26,85,0.306,86,192,0.448,0.451,56,82,0.683,21,91,112,162,20,8,74,51,306,westbru01
Scottie Barnes,PF,21,TOR,21,20,695,124,274,0.453,26,81,0.321,98,193,0.508,0.5,30,45,0.667,37,106,143,104,20,19,53,34,304,barnesc01
Jusuf Nurkić,C,28,POR,21,21,623,115,225,0.511,15,35,0.429,100,190,0.526,0.544,59,84,0.702,59,151,210,59,15,18,51,69,304,nurkiju01
Desmond Bane,SG,24,MEM,12,12,403,99,213,0.465,46,102,0.451,53,111,0.477,0.573,52,57,0.912,6,53,59,57,7,3,27,29,296,banede01
Fred VanVleet,PG,28,TOR,18,18,659,95,266,0.357,50,147,0.34,45,119,0.378,0.451,54,64,0.844,9,55,64,115,30,9,33,50,294,vanvlfr01
Harrison Barnes,PF,30,SAC,22,22,674,90,184,0.489,22,73,0.301,68,111,0.613,0.549,89,106,0.84,23,97,120,41,19,3,27,31,291,barneha02
Cameron Payne,PG,28,PHO,22,14,580,107,259,0.413,42,108,0.389,65,151,0.43,0.494,31,41,0.756,8,50,58,127,22,5,47,50,287,payneca01
Nic Claxton,C,23,BRK,24,24,672,127,174,0.73,0,1,0,127,173,0.734,0.73,28,65,0.431,64,147,211,30,17,52,32,72,282,claxtni01
Malcolm Brogdon,PG,30,BOS,20,0,465,96,197,0.487,38,77,0.494,58,120,0.483,0.584,48,56,0.857,20,63,83,74,11,4,38,30,278,brogdma01
Tre Jones,PG,23,SAS,23,23,695,104,250,0.416,18,59,0.305,86,191,0.45,0.452,52,57,0.912,17,61,78,158,35,4,47,43,278,jonestr01
Rudy Gobert,C,30,MIN,21,21,640,103,158,0.652,0,2,0,103,156,0.66,0.652,71,99,0.717,77,163,240,17,14,27,32,64,277,goberru01
Tim Hardaway Jr.,SG,30,DAL,22,5,549,90,248,0.363,59,166,0.355,31,82,0.378,0.482,38,45,0.844,6,50,56,43,17,4,20,28,277,hardati02
Trey Murphy III,SF,22,NOP,21,11,596,94,195,0.482,51,124,0.411,43,71,0.606,0.613,38,40,0.95,24,67,91,27,25,10,17,39,277,murphtr02
Jalen Smith,PF,22,IND,24,24,563,100,223,0.448,29,98,0.296,71,125,0.568,0.513,45,58,0.776,45,121,166,27,6,25,30,53,274,smithja04
Jabari Smith Jr.,PF,19,HOU,23,23,694,90,245,0.367,49,138,0.355,41,107,0.383,0.467,43,51,0.843,29,133,162,17,8,22,26,76,272,smithja05
John Collins,PF,25,ATL,22,22,693,103,213,0.484,16,73,0.219,87,140,0.621,0.521,49,58,0.845,26,138,164,28,20,31,30,71,271,collijo01
Derrick White,SG,28,BOS,25,20,655,90,192,0.469,46,106,0.434,44,86,0.512,0.589,43,48,0.896,14,61,75,83,21,17,24,64,269,whitede01
Ivica Zubac,C,25,LAC,25,25,761,106,169,0.627,0,1,0,106,168,0.631,0.627,55,81,0.679,87,200,287,31,11,43,55,75,267,zubaciv01
Marcus Smart,PG,28,BOS,22,22,729,96,212,0.453,41,115,0.357,55,97,0.567,0.55,33,43,0.767,9,60,69,168,25,7,49,66,266,smartma01
Kenyon Martin Jr.,SF,22,HOU,24,6,587,101,186,0.543,22,68,0.324,79,118,0.669,0.602,40,58,0.69,36,87,123,33,9,10,28,42,264,martike04
Jaylen Nowell,SG,23,MIN,23,0,417,101,234,0.432,31,97,0.32,70,137,0.511,0.498,31,39,0.795,16,48,64,46,14,2,22,35,264,nowelja01
Caleb Martin,PF,27,MIA,23,23,741,103,211,0.488,34,82,0.415,69,129,0.535,0.569,23,30,0.767,39,71,110,45,27,9,26,42,263,martica02
Michael Porter Jr.,SF,24,DEN,16,16,465,96,206,0.466,47,110,0.427,49,96,0.51,0.58,24,30,0.8,19,77,96,20,10,6,18,42,263,portemi01
Bruce Brown,PG,26,DEN,23,11,690,103,218,0.472,31,78,0.397,72,140,0.514,0.544,21,24,0.875,23,80,103,104,25,11,43,56,258,brownbr01
Jakob Poeltl,C,27,SAS,20,20,545,114,178,0.64,0,0,NA,114,178,0.64,0.64,29,56,0.518,77,120,197,69,18,20,48,46,257,poeltja01
John Wall,PG,32,LAC,20,0,442,90,207,0.435,18,66,0.273,72,141,0.511,0.478,58,87,0.667,6,46,52,113,18,5,47,34,256,walljo01
Clint Capela,C,28,ATL,22,22,614,116,189,0.614,0,0,NA,116,189,0.614,0.614,23,41,0.561,98,171,269,16,14,31,22,53,255,capelca01
Tyus Jones,PG,26,MEM,24,4,573,98,218,0.45,35,93,0.376,63,125,0.504,0.53,19,27,0.704,9,42,51,108,15,2,25,12,250,jonesty01
Wendell Carter Jr.,C,23,ORL,15,15,493,87,169,0.515,18,52,0.346,69,117,0.59,0.568,57,69,0.826,32,104,136,49,8,8,39,48,249,cartewe01
Eric Gordon,SG,34,HOU,20,20,601,82,188,0.436,38,108,0.352,44,80,0.55,0.537,44,51,0.863,6,33,39,51,14,7,38,15,246,gordoer01
Jalen McDaniels,SF,25,CHO,24,6,635,89,203,0.438,30,85,0.353,59,118,0.5,0.512,35,41,0.854,23,88,111,55,24,13,32,70,243,mcdanja01
Royce O'Neale,SF,29,BRK,25,25,897,84,220,0.382,58,142,0.408,26,78,0.333,0.514,16,23,0.696,20,112,132,117,29,17,44,83,242,onealro01
Kentavious Caldwell-Pope,SG,29,DEN,22,22,686,85,185,0.459,46,100,0.46,39,85,0.459,0.584,25,32,0.781,12,52,64,46,26,9,28,41,241,caldwke01
Immanuel Quickley,PG,23,NYK,24,0,548,83,200,0.415,28,91,0.308,55,109,0.505,0.485,47,56,0.839,16,91,107,72,24,3,35,43,241,quickim01
De'Anthony Melton,PG,24,PHI,22,15,635,91,225,0.404,44,123,0.358,47,102,0.461,0.502,14,21,0.667,26,72,98,74,45,10,40,48,240,meltode01
Cade Cunningham,PG,21,DET,12,12,400,93,224,0.415,17,61,0.279,76,163,0.466,0.453,36,43,0.837,12,62,74,72,10,7,39,34,239,cunnica01
Shake Milton,SG,26,PHI,20,8,486,92,176,0.523,18,46,0.391,74,130,0.569,0.574,33,38,0.868,16,52,68,72,7,4,38,31,235,miltosh01
Nick Richards,C,25,CHO,24,0,463,88,142,0.62,0,0,NA,88,142,0.62,0.62,54,74,0.73,74,90,164,16,2,18,22,53,230,richani01
Jarrett Allen,C,24,CLE,17,17,544,94,160,0.588,0,2,0,94,158,0.595,0.588,41,52,0.788,50,133,183,22,9,21,29,38,229,allenja01
Jose Alvarado,PG,24,NOP,23,6,487,85,180,0.472,38,94,0.404,47,86,0.547,0.578,21,25,0.84,10,45,55,77,27,4,31,51,229,alvarjo01
Austin Reaves,SG,24,LAL,22,8,632,71,133,0.534,24,62,0.387,47,71,0.662,0.624,63,69,0.913,16,55,71,44,9,7,22,31,229,reaveau01
Ayo Dosunmu,PG,23,CHI,22,20,624,94,182,0.516,22,66,0.333,72,116,0.621,0.577,18,20,0.9,12,63,75,64,14,9,34,56,228,dosunay01
Keegan Murray,SF,22,SAC,20,18,567,82,198,0.414,38,114,0.333,44,84,0.524,0.51,23,27,0.852,18,64,82,18,15,12,31,41,225,murrake02
Chris Boucher,PF,30,TOR,20,0,459,78,171,0.456,17,60,0.283,61,111,0.55,0.506,51,71,0.718,46,79,125,13,16,16,15,50,224,bouchch01
Caris LeVert,SG,28,CLE,20,14,619,76,204,0.373,30,82,0.366,46,122,0.377,0.446,42,53,0.792,19,70,89,90,15,2,37,45,224,leverca01
Jaden McDaniels,PF,22,MIN,20,20,586,88,163,0.54,22,59,0.373,66,104,0.635,0.607,26,34,0.765,28,40,68,26,22,27,31,75,224,mcdanja02
Mason Plumlee,C,32,CHO,24,24,663,85,145,0.586,0,0,NA,85,145,0.586,0.586,54,94,0.574,72,147,219,98,14,13,45,81,224,plumlma01
Santi Aldama,PF,22,MEM,23,16,581,83,180,0.461,29,86,0.337,54,94,0.574,0.542,27,38,0.711,35,100,135,31,19,24,14,61,222,aldamsa01
Georges Niang,PF,29,PHI,23,0,453,78,169,0.462,53,123,0.431,25,46,0.543,0.618,13,15,0.867,5,43,48,26,10,7,18,49,222,niangge01
Brandon Clarke,PF,26,MEM,24,2,461,91,151,0.603,1,6,0.167,90,145,0.621,0.606,37,51,0.725,29,86,115,29,8,21,29,54,220,clarkbr01
James Harden,SG,33,PHI,10,10,369,67,162,0.414,24,71,0.338,43,91,0.473,0.488,61,66,0.924,6,61,67,97,12,6,33,20,219,hardeja01
Grant Williams,PF,24,BOS,24,11,695,77,144,0.535,41,90,0.456,36,54,0.667,0.677,24,28,0.857,20,90,110,45,18,10,20,68,219,willigr01
Grayson Allen,SG,27,MIL,20,18,540,67,147,0.456,40,92,0.435,27,55,0.491,0.592,43,47,0.915,17,53,70,51,16,5,25,31,217,allengr01
Cedi Osman,SF,27,CLE,24,0,557,79,174,0.454,34,98,0.347,45,76,0.592,0.552,25,35,0.714,7,66,73,41,9,3,24,46,217,osmande01
Isaiah Stewart,C,21,DET,18,18,495,70,152,0.461,26,72,0.361,44,80,0.55,0.546,50,67,0.746,47,114,161,24,8,14,19,53,216,stewais01
Jalen Williams,SG,21,OKC,20,8,511,87,163,0.534,14,46,0.304,73,117,0.624,0.577,28,35,0.8,12,54,66,50,12,7,31,53,216,willija06
Tari Eason,PF,21,HOU,24,0,448,81,188,0.431,17,47,0.362,64,141,0.454,0.476,32,38,0.842,53,77,130,20,33,10,19,51,211,easonta01
Josh Hart,SG,27,POR,22,22,782,78,161,0.484,14,43,0.326,64,118,0.542,0.528,41,56,0.732,42,144,186,93,32,3,38,61,211,hartjo01
Bones Hyland,PG,22,DEN,15,0,307,69,173,0.399,40,92,0.435,29,81,0.358,0.514,33,41,0.805,4,25,29,50,9,4,27,24,211,hylanbo01
Patrick Williams,PF,21,CHI,23,22,596,77,171,0.45,29,69,0.42,48,102,0.471,0.535,27,29,0.931,26,66,92,18,16,23,36,48,210,willipa01
Jarred Vanderbilt,PF,23,UTA,24,24,598,87,143,0.608,12,26,0.462,75,117,0.641,0.65,20,32,0.625,55,143,198,66,28,6,39,69,206,vandeja01
Doug McDermott,SF,31,SAS,20,0,414,78,165,0.473,39,96,0.406,39,69,0.565,0.591,10,16,0.625,5,32,37,29,2,3,20,33,205,mcderdo01
Al Horford,C,36,BOS,20,20,632,79,147,0.537,41,88,0.466,38,59,0.644,0.677,5,8,0.625,20,105,125,55,9,20,15,40,204,horfoal01
Terance Mann,SG,26,LAC,25,12,531,81,149,0.544,15,46,0.326,66,103,0.641,0.594,27,37,0.73,24,60,84,45,14,6,26,49,204,mannte01
Killian Hayes,PG,21,DET,25,12,606,81,217,0.373,24,71,0.338,57,146,0.39,0.429,16,19,0.842,11,55,66,117,27,12,43,75,202,hayeski01
Damion Lee,SG,30,PHO,24,0,511,68,147,0.463,45,93,0.484,23,54,0.426,0.616,21,23,0.913,20,67,87,33,12,1,19,37,202,leeda03
Jeremiah Robinson-Earl,PF,22,OKC,23,16,490,77,155,0.497,28,70,0.4,49,85,0.576,0.587,20,26,0.769,43,72,115,22,19,10,14,44,202,robinje02
Jevon Carter,PG,27,MIL,23,21,622,74,172,0.43,34,85,0.4,40,87,0.46,0.529,16,19,0.842,14,48,62,81,32,15,33,60,198,carteje01
Terrence Ross,SG,31,ORL,22,8,538,76,178,0.427,37,94,0.394,39,84,0.464,0.531,9,13,0.692,7,42,49,29,16,4,27,33,198,rosste01
Draymond Green,PF,32,GSW,23,23,714,80,143,0.559,11,35,0.314,69,108,0.639,0.598,26,36,0.722,16,129,145,162,21,19,55,74,197,greendr01
Joe Harris,SG,31,BRK,23,14,600,70,176,0.398,46,125,0.368,24,51,0.471,0.528,11,15,0.733,11,63,74,39,13,6,14,58,197,harrijo01
Aleksej Pokusevski,PF,21,OKC,21,16,469,78,170,0.459,26,70,0.371,52,100,0.52,0.535,13,21,0.619,36,68,104,35,13,31,29,38,195,pokusal01
Dorian Finney-Smith,PF,29,DAL,23,23,753,70,174,0.402,40,122,0.328,30,52,0.577,0.517,14,19,0.737,29,66,95,23,22,11,21,41,194,finnedo01
AJ Griffin,SF,19,ATL,20,3,386,77,163,0.472,32,85,0.376,45,78,0.577,0.571,7,7,1,16,26,42,16,23,1,15,22,193,griffaj01
Tre Mann,PG,21,OKC,21,4,464,76,200,0.38,30,107,0.28,46,93,0.495,0.455,11,17,0.647,11,46,57,38,19,3,22,37,193,manntr01
Monte Morris,PG,27,WAS,21,21,571,75,168,0.446,25,66,0.379,50,102,0.49,0.521,17,23,0.739,9,68,77,106,16,4,18,27,192,morrimo01
Larry Nance Jr.,PF,30,NOP,21,0,466,82,124,0.661,7,17,0.412,75,107,0.701,0.69,19,25,0.76,33,77,110,36,17,17,21,45,190,nancela02
Obi Toppin,PF,24,NYK,24,0,421,71,168,0.423,33,94,0.351,38,74,0.514,0.521,14,17,0.824,14,79,93,26,10,5,19,28,189,toppiob01
Kevin Love,PF,34,CLE,18,1,376,58,138,0.42,39,99,0.394,19,39,0.487,0.562,33,38,0.868,13,120,133,43,3,3,23,25,188,loveke01
John Konchar,SG,26,MEM,22,14,614,68,145,0.469,37,90,0.411,31,55,0.564,0.597,14,16,0.875,30,112,142,31,24,7,17,39,187,konchjo01
Rui Hachimura,PF,24,WAS,16,0,376,76,158,0.481,12,36,0.333,64,122,0.525,0.519,21,29,0.724,12,65,77,17,5,8,22,18,185,hachiru01
Shaedon Sharpe,SG,19,POR,23,5,462,75,160,0.469,21,56,0.375,54,104,0.519,0.534,14,23,0.609,16,40,56,11,7,5,17,38,185,sharpsh01
Talen Horton-Tucker,SG,22,UTA,25,0,421,67,172,0.39,18,71,0.254,49,101,0.485,0.442,28,38,0.737,11,55,66,62,21,9,34,38,180,hortota01
Herbert Jones,SF,24,NOP,17,17,479,63,142,0.444,14,49,0.286,49,93,0.527,0.493,40,54,0.741,21,42,63,35,20,14,21,56,180,joneshe01
Gordon Hayward,SF,32,CHO,11,11,355,65,146,0.445,16,42,0.381,49,104,0.471,0.5,33,43,0.767,7,40,47,48,7,3,28,10,179,haywago01
Goran Dragić,PG,36,CHI,22,0,383,68,156,0.436,25,60,0.417,43,96,0.448,0.516,17,26,0.654,10,27,37,71,6,4,28,31,178,dragigo01
Sam Hauser,PF,25,BOS,25,0,417,61,121,0.504,49,106,0.462,12,15,0.8,0.707,7,9,0.778,9,52,61,19,6,7,7,36,178,hausesa01
Will Barton,SG,32,WAS,24,0,531,65,181,0.359,26,82,0.317,39,99,0.394,0.431,21,24,0.875,6,68,74,61,15,7,24,28,177,bartowi01
Onyeka Okongwu,C,22,ATL,23,2,468,75,116,0.647,0,2,0,75,114,0.658,0.647,27,37,0.73,49,90,139,24,12,17,21,69,177,okongon01
Keita Bates-Diop,SF,27,SAS,22,8,398,69,132,0.523,11,30,0.367,58,102,0.569,0.564,25,30,0.833,27,38,65,16,13,4,17,15,174,bateske01
Mike Conley,PG,35,UTA,17,17,497,58,148,0.392,32,83,0.386,26,65,0.4,0.5,26,34,0.765,7,34,41,134,20,5,25,35,174,conlemi01
Josh Richardson,SG,29,SAS,17,2,388,59,146,0.404,29,80,0.363,30,66,0.455,0.503,27,32,0.844,7,31,38,51,12,2,29,31,174,richajo01
Steven Adams,C,29,MEM,22,22,596,77,129,0.597,0,1,0,77,128,0.602,0.597,19,62,0.306,110,129,239,50,18,22,48,55,173,adamsst01
Deni Avdija,SF,22,WAS,24,21,567,64,163,0.393,18,68,0.265,46,95,0.484,0.448,27,36,0.75,22,99,121,55,17,17,33,74,173,avdijde01
Jalen Suggs,PG,21,ORL,14,13,405,65,155,0.419,20,68,0.294,45,87,0.517,0.484,23,35,0.657,15,31,46,76,22,9,47,44,173,suggsja01
Isaiah Jackson,PF,21,IND,23,3,379,63,114,0.553,1,4,0.25,62,110,0.564,0.557,45,64,0.703,35,66,101,24,11,29,23,56,172,jacksis01
Andrew Nembhard,SG,23,IND,19,10,452,66,136,0.485,30,70,0.429,36,66,0.545,0.596,10,11,0.909,9,45,54,79,17,3,25,50,172,nembhan01
Cam Reddish,SF,23,NYK,20,8,438,61,136,0.449,17,56,0.304,44,80,0.55,0.511,29,33,0.879,7,24,31,20,15,8,15,32,168,reddica01
Gabe Vincent,PG,26,MIA,19,0,472,60,154,0.39,27,91,0.297,33,63,0.524,0.477,21,25,0.84,5,34,39,56,16,2,26,49,168,vincega01
Alec Burks,SG,31,DET,12,0,245,50,117,0.427,20,54,0.37,30,63,0.476,0.513,47,58,0.81,4,27,31,20,12,1,13,31,167,burksal01
Josh Green,SG,22,DAL,23,1,464,56,93,0.602,24,52,0.462,32,41,0.78,0.731,30,43,0.698,20,33,53,28,23,1,16,56,166,greenjo02
Jeremy Sochan,PF,19,SAS,20,20,497,71,150,0.473,8,44,0.182,63,106,0.594,0.5,11,20,0.55,26,55,81,40,19,10,31,52,161,sochaje01
Justise Winslow,SF,26,POR,21,10,610,66,162,0.407,11,35,0.314,55,127,0.433,0.441,18,26,0.692,35,80,115,78,24,9,34,65,161,winslju01
Torrey Craig,SF,32,PHO,21,13,496,62,131,0.473,26,68,0.382,36,63,0.571,0.573,10,13,0.769,40,64,104,30,13,16,14,50,160,craigto01
Kevon Looney,C,26,GSW,25,25,567,68,102,0.667,0,0,NA,68,102,0.667,0.667,23,38,0.605,56,125,181,71,10,13,10,69,159,looneke01
Hamidou Diallo,SG,24,DET,24,0,370,60,123,0.488,2,13,0.154,58,110,0.527,0.496,35,55,0.636,23,45,68,23,13,5,21,51,157,diallha01
Mo Bamba,C,24,ORL,19,5,355,57,119,0.479,20,56,0.357,37,63,0.587,0.563,22,31,0.71,22,64,86,22,5,15,17,42,156,bambamo01
Corey Kispert,SF,23,WAS,16,9,426,56,103,0.544,30,65,0.462,26,38,0.684,0.689,14,19,0.737,8,29,37,28,10,3,10,24,156,kispeco01
Marvin Bagley III,PF,23,DET,12,11,294,63,111,0.568,7,19,0.368,56,92,0.609,0.599,22,27,0.815,28,54,82,8,10,8,15,29,155,baglema01
Jaren Jackson Jr.,C,23,MEM,8,8,210,51,105,0.486,14,42,0.333,37,63,0.587,0.552,39,49,0.796,19,34,53,1,7,23,14,25,155,jacksja02
Isaiah Hartenstein,C,24,NYK,24,7,501,64,120,0.533,4,18,0.222,60,102,0.588,0.55,21,25,0.84,71,94,165,18,19,23,22,62,153,harteis01
Aaron Nesmith,SF,23,IND,20,11,429,51,137,0.372,27,79,0.342,24,58,0.414,0.471,23,28,0.821,10,54,64,25,16,10,19,60,152,nesmiaa01
Troy Brown Jr.,SF,23,LAL,19,16,486,58,128,0.453,21,60,0.35,37,68,0.544,0.535,11,11,1,18,71,89,19,15,1,18,32,148,browntr01
Jordan Nwora,SF,24,MIL,21,3,400,49,134,0.366,26,69,0.377,23,65,0.354,0.463,24,29,0.828,19,56,75,23,7,3,20,21,148,nworajo01
Davion Mitchell,PG,24,SAC,22,1,423,59,132,0.447,18,59,0.305,41,73,0.562,0.515,11,15,0.733,2,29,31,51,12,5,23,36,147,mitchda01
David Roddy,PF,21,MEM,24,1,464,54,141,0.383,23,76,0.303,31,65,0.477,0.465,15,21,0.714,17,48,65,15,8,7,16,36,146,roddyda01
Naji Marshall,SF,25,NOP,21,4,427,52,125,0.416,17,52,0.327,35,73,0.479,0.484,23,29,0.793,16,46,62,45,15,4,18,26,144,marshna01
Edmond Sumner,SG,27,BRK,20,8,306,49,112,0.438,12,44,0.273,37,68,0.544,0.491,33,36,0.917,5,21,26,23,20,5,22,28,143,sumneed01
Jalen Duren,C,19,DET,22,0,476,61,103,0.592,0,1,0,61,102,0.598,0.592,20,43,0.465,63,84,147,14,13,20,21,53,142,durenja01
Taurean Prince,SF,28,MIN,18,0,352,51,103,0.495,21,54,0.389,30,49,0.612,0.597,19,22,0.864,6,39,45,21,6,4,21,43,142,princta02
Ben Simmons,PG,26,BRK,17,12,477,62,101,0.614,0,1,0,62,100,0.62,0.614,18,33,0.545,17,96,113,99,21,12,39,64,142,simmobe01
Daniel Gafford,C,24,WAS,24,0,320,57,79,0.722,0,0,NA,57,79,0.722,0.722,27,47,0.574,41,60,101,10,8,27,21,42,141,gaffoda01
Terence Davis,SG,25,SAC,20,1,264,49,112,0.438,28,71,0.394,21,41,0.512,0.563,14,16,0.875,9,51,60,30,16,4,15,36,140,daviste02
Dennis Smith Jr.,PG,25,CHO,15,11,419,62,134,0.463,10,30,0.333,52,104,0.5,0.5,6,12,0.5,9,40,49,85,27,10,23,34,140,smithde03
Dewayne Dedmon,C,33,MIA,20,0,244,52,96,0.542,9,26,0.346,43,70,0.614,0.589,25,33,0.758,19,53,72,12,4,8,13,39,138,dedmode01
Kenrich Williams,PF,28,OKC,21,3,429,59,112,0.527,14,38,0.368,45,74,0.608,0.589,6,14,0.429,35,45,80,29,13,4,8,40,138,willike04
R.J. Hampton,PG,21,ORL,21,0,327,46,105,0.438,17,49,0.347,29,56,0.518,0.519,27,31,0.871,9,25,34,32,16,4,19,20,136,hamptrj01
Naz Reid,C,23,MIN,17,0,246,54,103,0.524,11,38,0.289,43,65,0.662,0.578,16,25,0.64,10,49,59,13,5,17,12,40,135,reidna01
Derrick Rose,PG,34,NYK,21,0,285,54,135,0.4,17,49,0.347,37,86,0.43,0.463,10,10,1,8,29,37,42,7,5,17,14,135,rosede01
Seth Curry,SG,32,BRK,15,0,336,49,111,0.441,26,63,0.413,23,48,0.479,0.559,10,11,0.909,4,30,34,34,9,4,20,29,134,curryse01
Devonte' Graham,PG,27,NOP,23,0,370,40,107,0.374,36,91,0.396,4,16,0.25,0.542,18,23,0.783,5,29,34,51,12,6,14,19,134,grahade01
Walker Kessler,C,21,UTA,23,0,364,56,74,0.757,0,0,NA,56,74,0.757,0.757,21,37,0.568,47,74,121,14,4,39,15,46,133,kesslwa01
Javonte Green,SG,29,CHI,22,1,361,51,87,0.586,10,27,0.37,41,60,0.683,0.644,20,31,0.645,22,46,68,18,21,15,13,36,132,greenja02
Jock Landale,C,27,PHO,21,0,268,50,96,0.521,4,28,0.143,46,68,0.676,0.542,28,35,0.8,33,43,76,14,6,14,15,41,132,landajo01
Isaiah Livers,PF,24,DET,22,7,430,42,104,0.404,29,81,0.358,13,23,0.565,0.543,15,20,0.75,11,39,50,13,9,12,13,42,128,liveris01
Jeff Green,PF,36,DEN,16,3,319,47,89,0.528,5,20,0.25,42,69,0.609,0.556,28,36,0.778,12,29,41,19,6,3,16,33,127,greenje02
Alex Caruso,PG,28,CHI,23,7,593,40,99,0.404,20,56,0.357,20,43,0.465,0.505,24,31,0.774,9,54,63,85,33,18,32,53,124,carusal01
JaMychal Green,PF,32,GSW,22,0,332,51,101,0.505,6,34,0.176,45,67,0.672,0.535,14,18,0.778,31,54,85,15,13,8,22,45,122,greenja01
Drew Eubanks,C,25,POR,22,3,384,49,69,0.71,0,1,0,49,68,0.721,0.71,23,34,0.676,35,58,93,19,10,22,17,42,121,eubandr01
T.J. McConnell,PG,30,IND,21,0,377,53,114,0.465,4,12,0.333,49,102,0.48,0.482,11,12,0.917,14,39,53,90,26,5,37,26,121,mccontj01
Cam Thomas,SG,21,BRK,19,0,283,37,101,0.366,7,25,0.28,30,76,0.395,0.401,40,50,0.8,1,24,25,29,9,3,15,19,121,thomaca02
Théo Maledon,PG,21,CHO,22,1,368,43,96,0.448,14,36,0.389,29,60,0.483,0.521,20,23,0.87,5,47,52,55,18,5,26,22,120,maledth01
Jonathan Kuminga,PF,20,GSW,21,2,334,44,101,0.436,9,38,0.237,35,63,0.556,0.48,21,28,0.75,18,43,61,19,7,10,27,42,118,kuminjo01
Luke Kennard,SG,26,LAC,15,7,318,44,85,0.518,25,51,0.49,19,34,0.559,0.665,4,4,1,4,39,43,10,8,0,15,20,117,kennalu01
Kyle Anderson,PF,29,MIN,18,3,398,42,85,0.494,9,21,0.429,33,64,0.516,0.547,23,28,0.821,13,60,73,52,18,17,25,24,116,anderky01
Nicolas Batum,PF,34,LAC,25,1,467,39,94,0.415,27,71,0.38,12,23,0.522,0.559,11,19,0.579,17,83,100,32,14,19,18,50,116,batumni01
Nassir Little,PF,22,POR,21,0,321,43,91,0.473,16,43,0.372,27,48,0.563,0.56,14,21,0.667,7,43,50,18,8,3,14,17,116,littlna01
George Hill,PG,36,MIL,23,0,468,38,91,0.418,13,45,0.289,25,46,0.543,0.489,26,38,0.684,8,35,43,57,10,3,18,30,115,hillge01
Dwight Powell,C,31,DAL,20,16,342,44,64,0.688,0,1,0,44,63,0.698,0.688,27,41,0.659,35,32,67,10,11,8,17,49,115,poweldw01
Thaddeus Young,PF,34,TOR,21,8,359,50,94,0.532,3,15,0.2,47,79,0.595,0.548,12,14,0.857,38,46,84,39,21,2,18,35,115,youngth01
Jordan Goodwin,PG,24,WAS,17,1,351,45,91,0.495,13,27,0.481,32,64,0.5,0.566,11,17,0.647,21,47,68,47,14,13,16,33,114,goodwjo01
Yuta Watanabe,SF,28,BRK,14,0,255,42,69,0.609,24,42,0.571,18,27,0.667,0.783,6,9,0.667,10,31,41,13,3,7,5,16,114,watanyu01
Mitchell Robinson,C,24,NYK,16,15,374,50,69,0.725,0,0,NA,50,69,0.725,0.725,13,31,0.419,58,64,122,12,10,31,10,50,113,robinmi01
Maxi Kleber,C,31,DAL,19,0,478,41,87,0.471,19,54,0.352,22,33,0.667,0.58,11,14,0.786,16,50,66,20,6,17,12,40,112,klebima01
Coby White,PG,22,CHI,15,0,278,41,100,0.41,21,64,0.328,20,36,0.556,0.515,9,13,0.692,2,28,30,24,9,2,13,24,112,whiteco01
Zach Collins,PF,25,SAS,14,3,265,45,95,0.474,10,35,0.286,35,60,0.583,0.526,11,15,0.733,24,51,75,38,9,14,28,49,111,colliza01
Andre Drummond,C,29,CHI,17,0,241,47,87,0.54,0,2,0,47,85,0.553,0.54,17,26,0.654,45,86,131,14,9,7,20,34,111,drumman01
Landry Shamet,SG,25,PHO,15,0,249,35,86,0.407,24,62,0.387,11,24,0.458,0.547,17,19,0.895,4,10,14,18,7,2,16,22,111,shamela01
Danuel House Jr.,SF,29,PHI,22,2,405,36,75,0.48,15,43,0.349,21,32,0.656,0.58,21,28,0.75,4,40,44,17,6,5,13,30,108,houseda01
Dean Wade,PF,26,CLE,17,9,409,38,84,0.452,23,56,0.411,15,28,0.536,0.589,9,13,0.692,10,59,69,17,12,6,7,42,108,wadede01
Dalano Banton,PG,23,TOR,18,2,193,40,95,0.421,13,41,0.317,27,54,0.5,0.489,14,16,0.875,8,20,28,22,11,10,12,21,107,bantoda01
Reggie Bullock,SF,31,DAL,22,18,603,35,117,0.299,27,97,0.278,8,20,0.4,0.415,10,15,0.667,10,57,67,21,19,2,8,51,107,bullore01
Trey Lyles,PF,27,SAC,17,0,242,35,86,0.407,21,61,0.344,14,25,0.56,0.529,16,22,0.727,17,31,48,13,6,7,17,20,107,lylestr01
Garrison Mathews,SG,26,HOU,21,0,286,28,75,0.373,27,72,0.375,1,3,0.333,0.553,24,26,0.923,3,21,24,9,12,1,7,31,107,mathega01
Chimezie Metu,C,25,SAC,18,0,227,45,72,0.625,3,16,0.188,42,56,0.75,0.646,14,16,0.875,13,50,63,14,6,5,12,22,107,metuch01
Precious Achiuwa,C,23,TOR,12,0,245,36,92,0.391,5,28,0.179,31,64,0.484,0.418,28,33,0.848,24,60,84,16,2,7,15,19,105,achiupr01
Oshae Brissett,SF,24,IND,19,0,302,33,77,0.429,17,47,0.362,16,30,0.533,0.539,22,30,0.733,14,41,55,11,14,4,9,22,105,brissos01
Cole Anthony,PG,22,ORL,8,3,219,36,90,0.4,11,32,0.344,25,58,0.431,0.461,21,25,0.84,4,32,36,28,10,4,11,27,104,anthoco01
Cameron Johnson,PF,26,PHO,8,8,202,37,83,0.446,22,51,0.431,15,32,0.469,0.578,8,11,0.727,5,22,27,14,9,3,2,14,104,johnsca02
Jalen Johnson,SF,21,ATL,22,2,328,44,93,0.473,6,30,0.2,38,63,0.603,0.505,10,15,0.667,13,63,76,21,14,7,10,34,104,johnsja05
Kendrick Nunn,PG,27,LAL,19,2,253,40,112,0.357,16,57,0.281,24,55,0.436,0.429,8,9,0.889,1,25,26,24,2,1,24,16,104,nunnke01
Duncan Robinson,SF,28,MIA,17,0,293,36,100,0.36,23,73,0.315,13,27,0.481,0.475,9,10,0.9,4,31,35,21,4,0,11,32,104,robindu01
Montrezl Harrell,C,29,PHI,20,5,240,34,64,0.531,0,0,NA,34,64,0.531,0.531,35,47,0.745,21,38,59,10,4,8,13,22,103,harremo01
Aaron Wiggins,SG,24,OKC,17,5,330,37,80,0.463,13,33,0.394,24,47,0.511,0.544,16,20,0.8,17,44,61,29,9,4,11,26,103,wiggiaa01
Wenyen Gabriel,PF,25,LAL,20,2,271,40,67,0.597,4,13,0.308,36,54,0.667,0.627,18,22,0.818,26,47,73,13,11,10,14,35,102,gabriwe01
Justin Holiday,SG,33,ATL,18,0,303,39,97,0.402,24,68,0.353,15,29,0.517,0.526,0,0,NA,1,16,17,17,4,5,10,30,102,holidju01
DeAndre Jordan,C,34,DEN,19,3,298,43,57,0.754,1,1,1,42,56,0.75,0.763,14,30,0.467,31,81,112,19,3,12,25,31,101,jordade01
Isaac Okoro,SG,22,CLE,24,4,461,35,88,0.398,8,40,0.2,27,48,0.563,0.443,23,28,0.821,13,37,50,15,15,4,17,53,101,okorois01
James Bouknight,SG,22,CHO,19,0,327,38,113,0.336,14,59,0.237,24,54,0.444,0.398,10,16,0.625,5,40,45,26,9,4,18,28,100,bouknja01
Moses Moody,SG,20,GSW,20,1,292,32,77,0.416,18,50,0.36,14,27,0.519,0.532,18,22,0.818,5,31,36,12,7,5,20,14,100,moodymo01
Darius Bazley,PF,22,OKC,18,0,280,38,87,0.437,9,25,0.36,29,62,0.468,0.489,14,28,0.5,19,51,70,18,10,23,12,20,99,bazleda01
Christian Koloko,C,22,TOR,24,12,409,36,78,0.462,0,6,0,36,72,0.5,0.462,27,41,0.659,42,46,88,11,5,29,14,66,99,kolokch01
Anthony Lamb,SF,25,GSW,17,2,312,39,75,0.52,18,46,0.391,21,29,0.724,0.64,2,4,0.5,12,46,58,28,10,4,18,41,98,lamban01
Chuma Okeke,PF,24,ORL,18,7,392,32,87,0.368,18,60,0.3,14,27,0.519,0.471,16,21,0.762,21,55,76,26,11,9,9,34,98,okekech01
Aaron Holiday,PG,26,ATL,21,1,359,36,85,0.424,14,30,0.467,22,55,0.4,0.506,10,13,0.769,9,21,30,29,13,3,17,36,96,holidaa01
Chris Paul,PG,37,PHO,10,10,302,28,76,0.368,9,33,0.273,19,43,0.442,0.428,30,34,0.882,5,40,45,94,17,2,15,23,95,paulch01
Cory Joseph,PG,31,DET,19,2,274,36,81,0.444,13,32,0.406,23,49,0.469,0.525,9,14,0.643,5,13,18,54,5,1,9,29,94,josepco01
Luke Kornet,C,27,BOS,20,0,261,38,56,0.679,2,6,0.333,36,50,0.72,0.696,15,16,0.938,25,47,72,15,3,19,11,33,93,kornelu01
Isaiah Roby,PF,24,SAS,19,0,254,36,81,0.444,12,35,0.343,24,46,0.522,0.519,8,18,0.444,8,44,52,26,9,6,11,26,92,robyis01
Patty Mills,PG,34,BRK,20,0,219,30,71,0.423,21,55,0.382,9,16,0.563,0.57,10,10,1,5,11,16,21,4,1,7,10,91,millspa02
Evan Fournier,SG,30,NYK,13,7,260,31,90,0.344,19,57,0.333,12,33,0.364,0.45,9,11,0.818,2,25,27,22,9,3,14,28,90,fournev01
Kevin Knox,SF,23,DET,18,0,239,33,74,0.446,16,47,0.34,17,27,0.63,0.554,7,11,0.636,9,34,43,7,6,7,8,26,89,knoxke01
Mike Muscala,C,31,OKC,15,1,193,31,70,0.443,15,46,0.326,16,24,0.667,0.55,12,16,0.75,7,44,51,14,2,8,7,24,89,muscami01
Isaiah Joe,SG,23,OKC,17,0,140,29,59,0.492,23,50,0.46,6,9,0.667,0.686,7,9,0.778,2,20,22,16,7,1,6,15,88,joeis01
Malachi Flynn,PG,24,TOR,15,1,170,30,70,0.429,17,36,0.472,13,34,0.382,0.55,10,11,0.909,2,16,18,18,6,1,9,24,87,flynnma01
Derrick Jones Jr.,SF,25,CHI,18,0,230,27,61,0.443,4,18,0.222,23,43,0.535,0.475,28,33,0.848,17,24,41,8,7,12,8,23,86,jonesde02
Donte DiVincenzo,SG,26,GSW,17,1,294,29,77,0.377,17,54,0.315,12,23,0.522,0.487,10,13,0.769,11,41,52,35,17,2,22,33,85,divindo01
Usman Garuba,PF,20,HOU,22,1,339,32,56,0.571,7,11,0.636,25,45,0.556,0.634,14,24,0.583,39,69,108,23,19,16,19,42,85,garubus01
Amir Coffey,SG,25,LAC,21,6,313,25,66,0.379,4,18,0.222,21,48,0.438,0.409,30,37,0.811,9,15,24,27,5,2,10,27,84,coffeam01
Caleb Houstan,SF,20,ORL,20,1,379,28,78,0.359,20,56,0.357,8,22,0.364,0.487,8,10,0.8,14,39,53,16,4,2,5,35,84,houstca01
P.J. Tucker,PF,37,PHI,24,24,687,32,71,0.451,15,38,0.395,17,33,0.515,0.556,4,6,0.667,30,74,104,24,14,7,23,63,83,tuckepj01
Jake LaRavia,PF,21,MEM,16,0,295,29,70,0.414,19,49,0.388,10,21,0.476,0.55,5,5,1,13,37,50,16,9,3,15,33,82,laravja01
Trendon Watford,PF,22,POR,15,2,279,31,55,0.564,3,10,0.3,28,45,0.622,0.591,17,19,0.895,13,48,61,25,7,1,16,28,82,watfotr01
Robert Covington,PF,32,LAC,15,0,234,26,68,0.382,15,44,0.341,11,24,0.458,0.493,14,16,0.875,5,53,58,18,6,10,12,30,81,covinro01
Lamar Stevens,PF,25,CLE,11,8,236,29,63,0.46,7,17,0.412,22,46,0.478,0.516,16,19,0.842,7,24,31,4,4,6,6,16,81,stevela01
Vlatko Čančar,PF,25,DEN,15,0,191,30,64,0.469,14,34,0.412,16,30,0.533,0.578,6,7,0.857,4,21,25,14,7,4,8,22,80,cancavl01
Dyson Daniels,PG,19,NOP,15,2,281,31,62,0.5,9,22,0.409,22,40,0.55,0.573,9,14,0.643,8,50,58,33,11,5,11,29,80,daniedy01
Chris Duarte,SF,25,IND,9,5,177,28,71,0.394,13,38,0.342,15,33,0.455,0.486,11,12,0.917,4,15,19,9,1,4,8,16,80,duartch01
MarJon Beauchamp,SF,22,MIL,15,6,232,30,78,0.385,12,41,0.293,18,37,0.486,0.462,7,10,0.7,14,30,44,6,7,2,18,26,79,beaucma01
Quentin Grimes,SG,22,NYK,14,9,295,32,72,0.444,11,41,0.268,21,31,0.677,0.521,4,5,0.8,10,29,39,24,9,4,13,34,79,grimequ01
Charles Bassey,C,22,SAS,14,0,214,33,48,0.688,2,6,0.333,31,42,0.738,0.708,10,18,0.556,29,55,84,20,6,15,19,34,78,bassech01
Zeke Nnaji,PF,22,DEN,17,0,167,32,55,0.582,3,14,0.214,29,41,0.707,0.609,8,10,0.8,16,8,24,3,3,2,8,25,75,nnajize01
Payton Pritchard,PG,25,BOS,14,0,171,28,68,0.412,14,38,0.368,14,30,0.467,0.515,5,8,0.625,8,14,22,16,5,1,12,6,75,pritcpa01
James Wiseman,C,21,GSW,11,0,147,30,51,0.588,0,0,NA,30,51,0.588,0.588,15,23,0.652,11,31,42,11,1,4,8,26,75,wisemja01
Daishen Nix,PG,20,HOU,22,0,331,24,70,0.343,16,46,0.348,8,24,0.333,0.457,9,13,0.692,8,29,37,54,15,3,31,20,73,nixda01
Romeo Langford,SG,23,SAS,13,2,235,29,64,0.453,3,17,0.176,26,47,0.553,0.477,11,17,0.647,22,13,35,9,7,4,10,23,72,langfro01
Paul Reed,C,23,PHI,21,0,256,32,55,0.582,0,3,0,32,52,0.615,0.582,8,12,0.667,30,54,84,12,22,16,16,52,72,reedpa01
Jericho Sims,C,24,NYK,16,2,217,32,42,0.762,0,0,NA,32,42,0.762,0.762,8,10,0.8,34,42,76,7,5,15,7,32,72,simsje01
Patrick Beverley,PG,34,LAL,17,17,453,22,80,0.275,12,54,0.222,10,26,0.385,0.35,15,19,0.789,12,55,67,43,14,8,15,51,71,beverpa01
Juancho Hernangómez,PF,27,TOR,16,3,271,29,56,0.518,10,29,0.345,19,27,0.704,0.607,3,7,0.429,13,52,65,13,10,3,10,20,71,hernaju01
Moses Brown,C,23,LAC,17,0,101,25,38,0.658,0,0,NA,25,38,0.658,0.658,20,39,0.513,17,27,44,1,1,6,4,16,70,brownmo01
Kevon Harris,SG,25,ORL,17,0,214,22,55,0.4,6,17,0.353,16,38,0.421,0.455,20,24,0.833,18,22,40,9,7,1,14,23,70,harrike01
Moritz Wagner,C,25,ORL,7,3,170,24,51,0.471,3,22,0.136,21,29,0.724,0.5,19,23,0.826,13,34,47,18,4,2,14,26,70,wagnemo01
Duane Washington Jr.,SG,22,PHO,15,0,135,29,77,0.377,11,39,0.282,18,38,0.474,0.448,0,2,0,0,9,9,11,1,1,9,7,69,washidu02
Furkan Korkmaz,SG,25,PHI,13,0,168,22,52,0.423,10,27,0.37,12,25,0.48,0.519,13,18,0.722,4,12,16,13,3,2,10,7,67,korkmfu01
Jordan McLaughlin,PG,26,MIN,16,0,261,25,60,0.417,8,32,0.25,17,28,0.607,0.483,9,9,1,6,23,29,60,14,2,11,6,67,mclaujo01
Kawhi Leonard,SF,31,LAC,6,4,140,26,60,0.433,2,18,0.111,24,42,0.571,0.45,12,15,0.8,5,21,26,19,3,1,6,10,66,leonaka01
Anthony Gill,PF,30,WAS,20,4,240,26,48,0.542,2,13,0.154,24,35,0.686,0.563,11,13,0.846,14,20,34,11,4,5,4,30,65,gillan01
Nikola Jović,PF,19,MIA,10,6,160,21,53,0.396,5,25,0.2,16,28,0.571,0.443,18,19,0.947,7,19,26,10,6,1,8,12,65,jovicni01
JaVale McGee,C,35,DAL,16,7,141,27,46,0.587,0,0,NA,27,46,0.587,0.587,11,20,0.55,11,29,40,4,3,9,16,18,65,mcgeeja01
Bismack Biyombo,C,30,PHO,20,2,243,28,52,0.538,0,0,NA,28,52,0.538,0.538,8,20,0.4,18,49,67,16,6,28,21,36,64,biyombi01
Thomas Bryant,C,25,LAL,8,1,102,26,36,0.722,1,4,0.25,25,32,0.781,0.736,11,20,0.55,7,28,35,5,0,5,2,12,64,bryanth01
Dennis Schröder,PG,29,LAL,8,5,207,21,53,0.396,5,16,0.313,16,37,0.432,0.443,16,18,0.889,1,13,14,33,6,0,9,13,63,schrode01
Gary Harris,SG,28,ORL,6,3,155,23,48,0.479,10,23,0.435,13,25,0.52,0.583,6,6,1,5,11,16,12,4,2,9,13,62,harriga01
Nickeil Alexander-Walker,SG,24,UTA,15,0,158,22,56,0.393,9,28,0.321,13,28,0.464,0.473,8,9,0.889,3,11,14,22,8,4,11,21,61,alexani01
Ousmane Dieng,SF,19,OKC,14,0,220,25,59,0.424,10,34,0.294,15,25,0.6,0.508,1,4,0.25,6,34,40,20,5,4,7,12,61,diengou01
Haywood Highsmith,SF,26,MIA,15,1,282,23,68,0.338,11,36,0.306,12,32,0.375,0.419,4,10,0.4,15,49,64,9,12,6,11,11,61,highsha01
Robin Lopez,C,34,CLE,18,1,173,26,40,0.65,0,0,NA,26,40,0.65,0.65,9,12,0.75,17,9,26,8,1,2,12,23,61,lopezro01
Christian Braun,SG,21,DEN,21,0,267,23,57,0.404,7,20,0.35,16,37,0.432,0.465,7,13,0.538,13,30,43,15,8,3,6,19,60,braunch01
Serge Ibaka,PF,33,MIL,14,0,159,23,44,0.523,6,14,0.429,17,30,0.567,0.591,8,13,0.615,12,28,40,4,0,6,8,20,60,ibakase01
Admiral Schofield,PF,25,ORL,14,0,168,21,46,0.457,11,29,0.379,10,17,0.588,0.576,6,6,1,9,11,20,9,2,2,4,29,59,schofad01
LaMelo Ball,PG,21,CHO,3,3,98,22,53,0.415,10,32,0.313,12,21,0.571,0.509,4,5,0.8,0,11,11,21,3,1,11,8,58,ballla01
Malaki Branham,SF,19,SAS,11,2,188,21,64,0.328,8,35,0.229,13,29,0.448,0.391,8,10,0.8,2,16,18,20,2,2,11,14,58,branhma01
Simone Fontecchio,SF,27,UTA,15,0,133,19,49,0.388,14,35,0.4,5,14,0.357,0.531,6,9,0.667,7,11,18,6,2,3,8,13,58,fontesi01
Ty Jerome,SG,25,GSW,10,0,149,19,35,0.543,7,17,0.412,12,18,0.667,0.643,12,12,1,1,8,9,19,1,1,4,12,57,jeromty01
Wesley Matthews,SG,36,MIL,18,0,279,18,59,0.305,14,47,0.298,4,12,0.333,0.424,7,8,0.875,15,19,34,10,9,4,6,30,57,matthwe02
Rudy Gay,SF,36,UTA,12,0,189,21,58,0.362,9,34,0.265,12,24,0.5,0.44,3,6,0.5,6,35,41,10,5,6,10,16,54,gayru01
Goga Bitadze,C,23,IND,14,0,142,21,39,0.538,2,10,0.2,19,29,0.655,0.564,9,18,0.5,16,18,34,14,6,8,10,27,53,bitadgo01
Willy Hernangómez,C,28,NOP,10,0,99,17,35,0.486,0,3,0,17,32,0.531,0.486,18,22,0.818,15,25,40,5,3,2,11,10,52,hernawi01
Davon Reed,SG,27,DEN,18,1,199,16,53,0.302,11,30,0.367,5,23,0.217,0.406,8,10,0.8,4,24,28,9,5,2,12,21,51,reedda01
Josh Christopher,SG,21,HOU,17,0,122,21,48,0.438,3,14,0.214,18,34,0.529,0.469,5,6,0.833,5,14,19,10,5,1,12,12,50,chrisjo01
Pat Connaughton,SG,30,MIL,7,0,125,16,53,0.302,10,39,0.256,6,14,0.429,0.396,5,6,0.833,3,18,21,4,5,0,1,4,47,connapa01
Josh Okogie,SG,24,PHO,20,0,166,17,51,0.333,3,23,0.13,14,28,0.5,0.363,10,16,0.625,15,25,40,15,12,6,10,21,47,okogijo01
Eugene Omoruyi,SF,25,OKC,8,0,95,17,33,0.515,6,13,0.462,11,20,0.55,0.606,7,11,0.636,6,8,14,2,3,0,5,21,47,omorueu01
Matt Ryan,SF,25,LAL,12,0,129,15,49,0.306,13,35,0.371,2,14,0.143,0.439,4,5,0.8,2,12,14,4,2,0,3,14,47,ryanma01
Bruno Fernando,C,24,HOU,8,3,109,20,29,0.69,0,1,0,20,28,0.714,0.69,6,10,0.6,14,21,35,10,4,6,5,16,46,fernabr01
Blake Griffin,PF,33,BOS,9,4,132,17,30,0.567,4,11,0.364,13,19,0.684,0.633,8,11,0.727,11,21,32,8,3,0,6,20,46,griffbl01
Markelle Fultz,SG,24,ORL,4,4,97,19,43,0.442,2,6,0.333,17,37,0.459,0.465,5,6,0.833,5,8,13,16,5,1,8,6,45,fultzma01
Markieff Morris,PF,33,BRK,14,0,145,16,41,0.39,13,28,0.464,3,13,0.231,0.549,0,0,NA,5,22,27,14,5,2,8,17,45,morrima02
Raul Neto,PG,30,CLE,15,0,134,17,36,0.472,4,13,0.308,13,23,0.565,0.528,7,8,0.875,2,11,13,17,6,0,6,9,45,netora01
Otto Porter Jr.,SF,29,TOR,8,2,146,15,30,0.5,6,17,0.353,9,13,0.692,0.6,8,8,1,6,13,19,8,11,0,4,7,44,porteot01
Dario Šarić,PF,28,PHO,11,2,134,16,44,0.364,7,20,0.35,9,24,0.375,0.443,5,7,0.714,15,24,39,12,3,2,6,21,44,saricda01
Gorgui Dieng,C,33,SAS,11,1,117,16,37,0.432,8,27,0.296,8,10,0.8,0.541,3,4,0.75,9,22,31,19,1,5,11,19,43,dienggo01
Bryn Forbes,SG,29,MIN,12,0,124,15,45,0.333,6,24,0.25,9,21,0.429,0.4,7,7,1,3,3,6,9,7,0,5,9,43,forbebr01
Keon Johnson,SG,20,POR,6,0,106,16,45,0.356,8,23,0.348,8,22,0.364,0.444,2,6,0.333,3,12,15,10,5,2,13,10,42,johnske07
Brandon Boston Jr.,SG,21,LAC,7,0,59,15,35,0.429,7,11,0.636,8,24,0.333,0.529,4,6,0.667,3,4,7,3,2,0,3,3,41,bostobr01
Kai Jones,C,22,CHO,15,0,140,17,37,0.459,2,9,0.222,15,28,0.536,0.486,5,8,0.625,13,19,32,4,3,8,5,15,41,joneska01
Day'Ron Sharpe,C,21,BRK,15,0,113,15,31,0.484,3,4,0.75,12,27,0.444,0.532,8,12,0.667,13,30,43,9,3,7,8,24,41,sharpda01
Xavier Tillman Sr.,PF,24,MEM,11,0,127,17,33,0.515,2,6,0.333,15,27,0.556,0.545,4,12,0.333,15,16,31,8,4,5,7,13,40,tillmxa01
Ish Wainright,SF,28,PHO,9,1,124,13,28,0.464,12,24,0.5,1,4,0.25,0.679,2,3,0.667,9,9,18,10,5,2,3,16,40,wainris01
Bryce McGowens,SG,20,CHO,9,0,109,13,28,0.464,4,9,0.444,9,19,0.474,0.536,8,9,0.889,2,9,11,8,3,4,3,4,38,mcgowbr01
Austin Rivers,SG,30,MIN,13,2,169,11,31,0.355,4,20,0.2,7,11,0.636,0.419,12,13,0.923,0,14,14,8,2,1,6,13,38,riverau01
Richaun Holmes,PF,29,SAC,12,0,127,16,24,0.667,1,2,0.5,15,22,0.682,0.688,4,6,0.667,8,17,25,0,2,1,5,19,37,holmeri01
Ish Smith,PG,34,DEN,10,0,120,17,43,0.395,2,6,0.333,15,37,0.405,0.419,1,2,0.5,1,12,13,25,3,6,12,9,37,smithis01
Jamal Cain,SF,23,MIA,8,0,93,15,28,0.536,1,6,0.167,14,22,0.636,0.554,4,6,0.667,7,12,19,5,5,0,2,10,35,cainja01
David Duke Jr.,SG,23,BRK,13,0,101,16,35,0.457,0,4,0,16,31,0.516,0.457,3,4,0.75,4,8,12,9,4,1,9,19,35,dukeda01
JT Thor,PF,20,CHO,14,0,146,12,38,0.316,4,20,0.2,8,18,0.444,0.368,7,9,0.778,8,21,29,8,3,5,9,8,35,thorjt01
Taj Gibson,PF,37,WAS,12,0,77,12,25,0.48,1,6,0.167,11,19,0.579,0.5,8,8,1,6,12,18,4,4,2,3,14,33,gibsota01
Sandro Mamukelashvili,C,23,MIL,11,0,88,11,28,0.393,4,15,0.267,7,13,0.538,0.464,5,10,0.5,5,18,23,3,1,2,4,8,31,mamuksa01
KZ Okpala,PF,23,SAC,14,3,130,11,23,0.478,3,9,0.333,8,14,0.571,0.543,6,6,1,5,16,21,8,3,3,3,17,31,okpalkz01
Matisse Thybulle,SG,25,PHI,20,3,228,12,39,0.308,5,23,0.217,7,16,0.438,0.372,1,3,0.333,6,18,24,8,16,5,3,23,30,thybuma01
Dāvis Bertāns,PF,30,DAL,9,0,64,9,24,0.375,8,19,0.421,1,5,0.2,0.542,3,4,0.75,1,4,5,4,0,0,2,13,29,bertada01
Kennedy Chandler,PG,20,MEM,9,0,105,12,38,0.316,2,11,0.182,10,27,0.37,0.342,3,7,0.429,2,11,13,21,6,3,8,5,29,chandke01
Jarrett Culver,SG,23,ATL,5,1,90,11,23,0.478,1,7,0.143,10,16,0.625,0.5,6,9,0.667,5,20,25,5,5,1,5,10,29,culveja01
Max Christie,SG,19,LAL,10,0,112,9,23,0.391,7,16,0.438,2,7,0.286,0.543,3,4,0.75,1,21,22,5,3,0,2,5,28,chrisma02
Jordan Hall,SF,21,SAS,9,0,83,9,28,0.321,3,15,0.2,6,13,0.462,0.375,7,9,0.778,3,9,12,11,1,0,7,6,28,halljo02
Joshua Primo,SG,20,SAS,4,0,93,9,26,0.346,3,12,0.25,6,14,0.429,0.404,7,9,0.778,2,11,13,18,1,2,11,8,28,primojo01
Terry Taylor,SG,23,IND,15,2,128,11,31,0.355,2,10,0.2,9,21,0.429,0.387,4,5,0.8,9,13,22,6,2,4,4,13,28,taylote01
Khem Birch,C,30,TOR,13,0,91,12,20,0.6,1,1,1,11,19,0.579,0.625,2,2,1,6,8,14,4,4,2,4,17,27,birchkh01
Damian Jones,C,27,LAL,11,1,82,10,21,0.476,0,1,0,10,20,0.5,0.476,7,10,0.7,9,17,26,3,1,5,5,10,27,jonesda03
Garrett Temple,SG,36,NOP,9,0,70,9,22,0.409,5,13,0.385,4,9,0.444,0.523,3,4,0.75,1,5,6,3,6,1,3,6,26,templga01
Juan Toscano-Anderson,SF,29,LAL,12,0,127,10,25,0.4,2,11,0.182,8,14,0.571,0.44,4,5,0.8,1,21,22,6,3,3,8,17,26,toscaju01
Delon Wright,PG,30,WAS,4,0,91,10,24,0.417,3,12,0.25,7,12,0.583,0.479,3,5,0.6,4,6,10,13,11,4,4,5,26,wrighde01
Ochai Agbaji,SG,22,UTA,8,0,72,10,21,0.476,1,7,0.143,9,14,0.643,0.5,4,7,0.571,4,6,10,1,1,0,0,8,25,agbajoc01
Jae'Sean Tate,SF,27,HOU,3,2,68,10,20,0.5,2,5,0.4,8,15,0.533,0.55,3,4,0.75,8,5,13,10,3,0,5,15,25,tateja01
Noah Vonleh,C,27,BOS,16,1,142,11,22,0.5,1,3,0.333,10,19,0.526,0.523,2,2,1,17,23,40,5,2,6,10,29,25,vonleno01
Jabari Walker,SF,20,POR,13,0,105,10,26,0.385,1,8,0.125,9,18,0.5,0.404,4,6,0.667,7,22,29,9,1,2,4,11,25,walkeja01
Mamadi Diakite,PF,26,CLE,10,2,81,10,21,0.476,4,12,0.333,6,9,0.667,0.571,0,0,NA,3,8,11,2,2,4,5,11,24,diakima01
A.J. Green,SG,23,MIL,8,0,47,7,14,0.5,6,12,0.5,1,2,0.5,0.714,3,3,1,1,6,7,2,1,0,1,7,23,greenaj01
Lindy Waters III,SG,25,OKC,5,0,69,8,23,0.348,7,22,0.318,1,1,1,0.5,0,0,NA,2,8,10,2,3,0,0,5,23,waterli01
Bogdan Bogdanović,SG,30,ATL,2,0,45,8,22,0.364,6,16,0.375,2,6,0.333,0.5,0,0,NA,0,5,5,2,1,0,5,1,22,bogdabo01
Khris Middleton,SF,31,MIL,2,2,52,7,22,0.318,3,11,0.273,4,11,0.364,0.386,5,6,0.833,0,3,3,12,1,0,2,6,22,middlkh01
Moussa Diabaté,PF,21,LAC,5,0,53,7,11,0.636,0,0,NA,7,11,0.636,0.636,7,8,0.875,10,9,19,1,2,1,3,5,21,diabamo01
Frank Kaminsky,C,29,ATL,10,0,61,7,12,0.583,3,6,0.5,4,6,0.667,0.708,4,4,1,0,12,12,6,0,0,3,10,21,kaminfr01
Miles McBride,PG,22,NYK,12,0,82,9,28,0.321,1,15,0.067,8,13,0.615,0.339,2,6,0.333,0,3,3,15,5,0,3,9,21,mcbrimi01
Jeff Dowtin,PG,25,TOR,8,0,64,9,17,0.529,1,4,0.25,8,13,0.615,0.559,1,1,1,4,6,10,8,0,1,1,4,20,dowtije01
Wendell Moore Jr.,SG,21,MIN,6,2,48,7,16,0.438,2,8,0.25,5,8,0.625,0.5,2,3,0.667,1,5,6,3,1,1,4,6,18,moorewe01
Greg Brown III,PF,21,POR,7,0,50,7,15,0.467,1,5,0.2,6,10,0.6,0.5,2,8,0.25,1,6,7,0,3,4,3,7,17,browngr01
Udoka Azubuike,C,23,UTA,9,0,35,7,8,0.875,0,0,NA,7,8,0.875,0.875,2,6,0.333,4,12,16,3,2,2,2,2,16,azubuud01
Blake Wesley,SG,19,SAS,2,0,23,6,9,0.667,2,3,0.667,4,6,0.667,0.778,2,4,0.5,1,1,2,4,0,0,2,3,16,weslebl01
Jaden Hardy,SG,20,DAL,5,0,19,6,15,0.4,1,5,0.2,5,10,0.5,0.433,2,2,1,0,3,3,1,0,0,2,5,15,hardyja02
Rodney McGruder,SG,31,DET,8,2,68,5,19,0.263,3,14,0.214,2,5,0.4,0.342,2,2,1,6,8,14,7,0,0,3,2,15,mcgruro01
Ryan Rollins,PG,20,GSW,7,0,43,5,15,0.333,3,8,0.375,2,7,0.286,0.433,2,2,1,1,6,7,3,0,0,12,9,15,rolliry01
Jason Preston,PG,23,LAC,4,0,27,6,13,0.462,2,7,0.286,4,6,0.667,0.538,0,2,0,1,2,3,5,0,0,2,2,14,prestja01
Orlando Robinson,C,22,MIA,2,0,40,6,13,0.462,0,3,0,6,10,0.6,0.462,2,3,0.667,2,7,9,1,2,1,1,5,14,robinor01
T.J. Warren,SF,29,BRK,2,0,35,6,15,0.4,0,2,0,6,13,0.462,0.4,2,2,1,4,2,6,1,1,1,1,2,14,warretj01
Jaylin Williams,PF,20,OKC,5,0,35,5,11,0.455,0,2,0,5,9,0.556,0.455,4,6,0.667,5,5,10,3,1,0,2,6,14,willija07
Matthew Dellavedova,PG,32,SAC,9,0,59,5,17,0.294,2,5,0.4,3,12,0.25,0.353,1,3,0.333,1,3,4,11,2,0,4,5,13,dellama01
James Johnson,PF,35,IND,7,0,62,6,16,0.375,1,7,0.143,5,9,0.556,0.406,0,0,NA,0,8,8,5,1,2,2,16,13,johnsja01
Vit Krejci,PG,22,ATL,11,0,65,5,15,0.333,3,12,0.25,2,3,0.667,0.433,0,0,NA,1,4,5,8,0,1,1,6,13,krejcvi01
Svi Mykhailiuk,SF,25,NYK,7,0,23,4,7,0.571,4,5,0.8,0,2,0,0.857,1,3,0.333,0,5,5,0,0,0,1,0,13,mykhasv01
Alex Len,C,29,SAC,7,0,23,5,8,0.625,0,0,NA,5,8,0.625,0.625,1,2,0.5,3,5,8,1,0,0,0,3,11,lenal01
Kenneth Lofton Jr.,PF,20,MEM,4,0,19,5,12,0.417,0,1,0,5,11,0.455,0.417,1,3,0.333,1,2,3,3,0,0,1,3,11,loftoke01
Nerlens Noel,C,28,DET,6,0,62,4,13,0.308,0,0,NA,4,13,0.308,0.308,3,4,0.75,3,16,19,3,5,2,3,9,11,noelne01
Mark Williams,C,21,CHO,3,0,13,4,7,0.571,0,0,NA,4,7,0.571,0.571,3,3,1,4,4,8,0,0,0,2,3,11,willima07
Patrick Baldwin Jr.,SF,20,GSW,4,0,24,4,10,0.4,2,8,0.25,2,2,1,0.5,0,0,NA,0,6,6,0,3,0,1,0,10,baldwpa01
Facundo Campazzo,PG,31,DAL,8,0,52,3,13,0.231,3,11,0.273,0,2,0,0.346,1,2,0.5,0,2,2,9,6,0,3,3,10,campafa01
Trent Forrest,PG,24,ATL,8,0,62,5,10,0.5,0,0,NA,5,10,0.5,0.5,0,0,NA,2,5,7,9,2,0,2,4,10,forretr01
Jaxson Hayes,C,22,NOP,9,0,67,3,16,0.188,0,8,0,3,8,0.375,0.188,4,7,0.571,3,13,16,5,3,1,3,6,10,hayesja02
Boban Marjanović,C,34,HOU,7,0,25,3,7,0.429,0,1,0,3,6,0.5,0.429,4,6,0.667,1,6,7,1,1,1,2,1,10,marjabo01
Dalen Terry,SG,20,CHI,10,0,33,3,11,0.273,1,4,0.25,2,7,0.286,0.318,3,4,0.75,0,2,2,5,1,2,4,2,10,terryda01
Kendall Brown,SG,19,IND,5,0,35,4,7,0.571,0,1,0,4,6,0.667,0.571,1,2,0.5,2,4,6,3,3,0,1,6,9,brownke03
Johnny Davis,SG,20,WAS,8,0,45,3,11,0.273,0,2,0,3,9,0.333,0.273,3,3,1,1,4,5,2,0,1,1,12,9,davisjo06
Tyler Dorsey,SG,26,DAL,1,0,4,4,4,1,1,1,1,3,3,1,1.125,0,0,NA,1,1,2,0,0,0,0,0,9,dorsety01
Kessler Edwards,SF,22,BRK,12,0,39,3,13,0.231,2,7,0.286,1,6,0.167,0.308,1,2,0.5,2,3,5,2,2,1,1,1,9,edwarke02
Isaiah Mobley,PF,23,CLE,7,0,25,4,8,0.5,1,2,0.5,3,6,0.5,0.563,0,0,NA,1,10,11,0,1,0,0,2,9,mobleis01
Frank Ntilikina,PG,24,DAL,7,0,39,4,11,0.364,1,5,0.2,3,6,0.5,0.409,0,0,NA,0,6,6,4,3,0,2,4,9,ntilila01
Dru Smith,SG,25,MIA,3,0,42,4,9,0.444,1,3,0.333,3,6,0.5,0.5,0,0,NA,0,7,7,2,3,3,1,6,9,smithdr01
Dominick Barlow,SF,19,SAS,3,0,22,2,6,0.333,0,3,0,2,3,0.667,0.333,4,4,1,2,1,3,3,1,0,0,3,8,barlodo01
Tony Bradley,C,25,CHI,6,0,15,2,4,0.5,1,2,0.5,1,2,0.5,0.625,2,2,1,1,6,7,0,1,0,0,0,7,bradlto01
Alize Johnson,PF,26,SAS,3,0,24,3,6,0.5,0,2,0,3,4,0.75,0.5,1,2,0.5,2,7,9,0,1,0,3,1,7,johnsal02
Tyrese Martin,SG,23,ATL,7,0,21,3,6,0.5,1,3,0.333,2,3,0.667,0.583,0,0,NA,2,2,4,0,1,0,0,1,7,martity01
Vince Williams Jr.,SG,22,MEM,6,0,40,3,11,0.273,1,8,0.125,2,3,0.667,0.318,0,0,NA,1,4,5,2,4,1,0,5,7,willivi01
Justin Champagnie,SF,21,TOR,2,0,9,3,3,1,0,0,NA,3,3,1,1,0,0,NA,1,2,3,0,0,0,0,1,6,champju01
Ron Harper Jr.,SF,22,TOR,2,0,8,2,4,0.5,2,3,0.667,0,1,0,0.75,0,0,NA,0,1,1,0,0,0,0,0,6,harpero02
Justin Jackson,SF,27,BOS,9,0,46,2,10,0.2,2,9,0.222,0,1,0,0.3,0,0,NA,0,5,5,2,2,1,0,3,6,jacksju01
Saben Lee,PG,23,PHI,2,0,10,3,4,0.75,0,1,0,3,3,1,0.75,0,0,NA,0,0,0,2,1,0,3,1,6,leesa01
Peyton Watson,SG,20,DEN,6,0,15,3,9,0.333,0,1,0,3,8,0.375,0.333,0,0,NA,2,1,3,0,0,0,0,1,6,watsope01
Nathan Knight,PF,25,MIN,9,0,24,1,3,0.333,0,1,0,1,2,0.5,0.333,3,5,0.6,0,6,6,0,3,0,2,2,5,knighna01
Jaden Springer,PG,20,PHI,2,0,4,2,3,0.667,0,0,NA,2,3,0.667,0.667,1,2,0.5,1,1,2,0,0,1,0,1,5,sprinja01
Leandro Bolmaro,SG,22,UTA,4,0,23,2,7,0.286,0,2,0,2,5,0.4,0.286,0,0,NA,1,0,1,3,2,1,3,4,4,bolmale01
Braxton Key,SF,25,DET,3,0,9,1,1,1,0,0,NA,1,1,1,1,2,2,1,0,1,1,0,0,0,0,0,4,keybr01
Josh Minott,SF,20,MIN,1,0,5,1,1,1,0,0,NA,1,1,1,1,2,2,1,2,1,3,1,0,1,0,1,4,minotjo01
Theo Pinson,SG,27,DAL,7,0,24,1,4,0.25,0,3,0,1,1,1,0.25,2,2,1,0,6,6,2,1,0,1,1,4,pinsoth01
Micah Potter,PF,24,UTA,2,0,12,2,2,1,0,0,NA,2,2,1,1,0,0,NA,1,2,3,1,0,0,0,2,4,pottemi01
Udonis Haslem,PF,42,MIA,4,0,24,1,6,0.167,0,1,0,1,5,0.2,0.167,1,2,0.5,2,2,4,0,1,1,0,4,3,hasleud01
Trevor Hudgins,PG,23,HOU,1,0,4,1,1,1,1,1,1,0,0,NA,1.5,0,0,NA,0,0,0,0,0,0,0,0,3,hudgitr01
Scotty Pippen Jr.,PG,22,LAL,2,0,8,0,2,0,0,0,NA,0,2,0,0,3,4,0.75,1,1,2,0,0,0,1,2,3,pippesc02
Jordan Schakel,SF,24,WAS,2,0,6,1,2,0.5,1,1,1,0,1,0,0.75,0,0,NA,0,0,0,1,1,0,0,1,3,schakjo01
Thanasis Antetokounmpo,SF,30,MIL,11,0,43,1,4,0.25,0,1,0,1,3,0.333,0.25,0,0,NA,2,9,11,2,0,2,4,3,2,antetth01
John Butler,C,20,POR,4,0,15,1,3,0.333,0,2,0,1,1,1,0.333,0,0,NA,1,1,2,1,0,1,0,0,2,butlejo01
JD Davison,PG,20,BOS,3,0,8,1,4,0.25,0,2,0,1,2,0.5,0.25,0,0,NA,0,1,1,1,1,0,1,0,2,davisjd01
Mfiondu Kabengele,PF,25,BOS,1,0,8,1,2,0.5,0,1,0,1,1,1,0.5,0,0,NA,3,1,4,0,0,0,0,1,2,kabenmf01
A.J. Lawson,SG,22,MIN,1,0,2,1,1,1,0,0,NA,1,1,1,1,0,0,NA,0,1,1,0,0,0,0,1,2,lawsoaj01
Chima Moneke,SF,27,SAC,2,0,8,1,2,0.5,0,0,NA,1,2,0.5,0.5,0,2,0,2,0,2,1,0,0,2,2,2,monekch01
Isaiah Todd,PF,21,WAS,4,0,13,1,4,0.25,0,3,0,1,1,1,0.25,0,0,NA,0,0,0,0,0,0,0,0,2,toddis01
Jack White,SF,25,DEN,8,0,26,1,6,0.167,0,2,0,1,4,0.25,0.167,0,0,NA,2,3,5,0,1,2,0,4,2,whiteja03
McKinley Wright IV,PG,24,DAL,1,0,5,1,4,0.25,0,1,0,1,3,0.333,0.25,0,0,NA,1,1,2,2,1,0,0,0,2,wrighmc01
TyTy Washington Jr.,PG,21,HOU,1,0,4,0,0,NA,0,0,NA,0,0,NA,NA,1,2,0.5,0,0,0,0,0,0,0,0,1,washity02
Ryan Arcidiacono,PG,28,NYK,6,0,16,0,3,0,0,2,0,0,1,0,0,0,0,NA,0,2,2,2,2,0,1,2,0,arcidry01
Buddy Boeheim,PG,23,DET,1,0,1,0,0,NA,0,0,NA,0,0,NA,NA,0,0,NA,0,0,0,0,0,0,0,0,0,boehebu01
Vernon Carey Jr.,C,21,WAS,3,0,5,0,2,0,0,0,NA,0,2,0,0,0,0,NA,0,1,1,0,0,0,1,2,0,careyve01
Julian Champagnie,SF,21,PHI,2,0,7,0,2,0,0,1,0,0,1,0,0,0,0,NA,0,0,0,0,1,0,0,0,0,champju02
Devon Dotson,PG,23,WAS,2,0,21,0,3,0,0,1,0,0,2,0,0,0,0,NA,3,1,4,2,1,0,0,3,0,dotsode01
Keon Ellis,SG,23,SAC,1,0,2,0,0,NA,0,0,NA,0,0,NA,NA,0,0,NA,0,0,0,0,0,0,0,1,0,elliske01
Michael Foster Jr.,PF,20,PHI,1,0,1,0,0,NA,0,0,NA,0,0,NA,NA,0,0,NA,0,0,0,0,0,0,0,0,0,fostemi02
Luka Garza,C,24,MIN,1,0,1,0,0,NA,0,0,NA,0,0,NA,NA,0,0,NA,0,0,0,0,0,0,0,0,0,garzalu01
Malcolm Hill,SF,27,CHI,3,0,1,0,0,NA,0,0,NA,0,0,NA,NA,0,0,NA,0,1,1,0,0,0,0,0,0,hillma01
Trevor Keels,SG,19,NYK,1,0,1,0,1,0,0,1,0,0,0,NA,0,0,0,NA,0,1,1,0,0,0,0,0,0,keelstr01
Cody Martin,SF,27,CHO,1,0,1,0,0,NA,0,0,NA,0,0,NA,NA,0,0,NA,0,0,0,0,0,0,0,0,0,martico01
Trevelin Queen,PG,25,IND,2,0,20,0,3,0,0,3,0,0,0,NA,0,0,0,NA,1,2,3,2,1,1,3,1,0,queentr01
Dereon Seabron,SG,22,NOP,2,0,3,0,0,NA,0,0,NA,0,0,NA,NA,0,0,NA,0,0,0,0,0,0,0,0,0,seabrde01
Marko Simonovic,C,23,CHI,1,0,2,0,1,0,0,1,0,0,0,NA,0,0,0,NA,0,0,0,0,0,0,0,0,0,simonma01
Cole Swider,SF,23,LAL,1,0,2,0,1,0,0,1,0,0,0,NA,0,0,0,NA,0,1,1,1,0,0,0,0,0,swideco01
